{
  "C1": 6,
  "C2": 7,
  "C3": 8,
  "C4": 9,
  "C5": 10,
  "P1": 1,
  "P2": 2,
  "P3": 3,
  "P4": 4,
  "P5": 5
}